12 12 12 12 12 12 12 12 12 12 12 12 12 12 12 12 12 12 12 12 12 12 12 12 12 12 12 12 12 12 12 12 
12 7 0 0 0 0 0 0 0 0 0 0 0 0 0 0 0 0 0 0 0 0 0 0 0 0 0 0 0 0 0 8 
12 0 0 0 0 0 0 0 0 0 0 0 0 0 0 0 0 0 0 0 0 0 0 0 0 0 0 0 0 0 0 8 
12 0 0 0 0 14 0 0 0 0 0 0 0 0 0 14 0 0 0 0 0 0 0 0 0 0 0 0 0 14 0 14 
12 0 0 0 0 0 0 0 0 0 0 0 0 0 0 0 14 0 0 0 0 0 0 0 0 0 0 14 0 0 0 8 
12 0 0 14 0 0 0 0 0 0 0 0 0 0 0 0 0 0 0 0 0 14 0 0 0 0 0 0 0 0 0 8 
12 0 14 0 0 0 0 0 0 0 0 0 0 0 0 0 0 0 0 0 0 0 0 0 14 0 0 0 0 0 0 14 
12 0 0 0 0 14 0 0 0 0 0 0 0 0 0 0 0 0 0 0 0 0 0 0 0 0 0 0 0 14 0 8 
12 0 0 0 0 0 0 0 0 0 0 0 0 0 0 0 0 0 0 0 0 0 14 0 0 0 0 14 0 0 0 8 
12 0 0 0 0 0 0 0 0 0 0 0 14 0 0 0 0 0 0 0 0 0 0 0 0 0 0 0 0 0 0 8 
11 11 11 11 11 11 11 2 2 11 11 11 11 11 11 0 0 0 0 0 0 0 0 0 0 0 0 0 0 0 0 8 
11 2 2 20 2 11 2 2 2 2 11 2 23 2 11 0 0 0 0 0 0 0 0 14 0 0 0 0 0 0 0 8 
11 2 2 2 2 11 2 2 2 2 11 2 2 2 11 0 0 0 0 14 0 0 0 0 0 0 0 0 0 0 0 8 
11 2 2 2 2 11 2 2 2 2 11 2 2 2 11 0 0 0 0 0 0 0 0 0 0 14 0 0 0 0 0 8 
11 11 11 2 11 11 2 2 2 2 11 2 11 11 11 0 0 0 0 0 0 0 0 14 0 0 0 0 0 0 0 8 
11 2 2 2 2 2 2 2 2 2 2 2 2 2 11 0 0 14 0 0 0 14 0 0 0 0 0 0 0 0 0 8 
11 2 2 2 2 2 2 2 2 2 2 2 2 2 11 0 0 0 0 0 0 0 0 0 0 0 0 0 0 0 0 8 
11 2 2 2 2 2 2 2 2 2 11 11 11 11 11 0 0 0 14 0 0 0 0 0 14 0 0 0 0 14 0 8 
11 2 2 2 2 2 2 2 2 2 2 2 22 2 11 0 0 0 0 0 0 0 0 0 0 0 0 14 0 0 0 8 
11 11 11 2 11 11 11 11 2 11 11 2 2 2 11 0 0 14 0 0 0 0 14 0 0 0 0 0 0 0 0 14 
11 2 2 2 2 11 2 2 2 21 11 2 2 2 11 0 0 0 0 0 0 0 0 0 0 13 13 13 13 13 13 13 
11 2 2 2 2 11 2 2 2 2 11 2 2 2 11 0 0 0 0 14 0 0 14 0 0 13 30 2 14 0 0 14 
11 2 2 2 2 11 2 2 2 2 11 2 2 2 11 0 0 0 0 0 0 0 0 0 0 13 2 2 0 0 0 8 
11 11 11 11 11 11 11 11 11 11 11 11 11 11 11 12 12 12 12 12 12 12 12 12 12 13 12 12 12 12 12 12 
